S||||||||||||||||||||||||||||||
               |              |
||||||||||  |  ||||  |  |||||||
|           |  |     |  |     |
||||  |  ||||  |  |  |||||||  |
|     |     |  |  |     |     |
|  ||||  ||||||||||  |||||||  |
|  |           |        |     |
|  ||||  |||||||  |||||||  |  |
|     |  |  |              |  |
|  |  |  |  |  ||||||||||||||||
|  |  |     |     |     |     |
|  ||||  ||||  ||||  |  |  ||||
|  |              |  |     |  |
||||  |  ||||||||||  |||||||  |
|     |     | ||              |
|  ||||  |  | |||||  ||||  ||||
|     |  |  | ||| |     |     |
|  |  ||||  | ||| ||||  |  ||||
|  |  |                 |     E
|||||||||||||||||||||||||||||||