|S        ||||
| ||||||| ||||
| ||||||| ||||
| |||||||    |
|        ||| |
|||||||| ||| |
|            |
||||||| |||| |
|     |      |
||||||| |||| |
|||||||      |
||||||||||||E|